 _| |_ _ _ _ _|_ 
|_ _ _| | | |  _|
  |_ _ _ _|_|_|  
|  _ _ _|    _ _|
|_|_ _   _  | | |
|_| |_ _ _  | | |
|_ _ _|  _ _|_|_|
| |_  |_| |_  |_ 
3 7
7 2 