 _| |_ _ _ _| |_ 
|_|_ _ _|_| |_ _ 
 _|_|_ _  |  _ _ 
|   |_  | |_ _ _|
 _|_   _ _| |  _  
 _ _|_|_| | |_|  
|_  |_ _| |  _ _|
| |_|  _|_|_| |_|
1 1
7 7