 _ _|  _ _ _| |_ 
|_ _|_   _ _|_ _|
 _|  _|_ _|_|_|  
| |_ _  |    _ _|
 _  | |_ _  |  _  
  |_ _|_ _|_| |  
|_|  _ _|_ _|_ _|
| |_|  _| |_  |_|
2 7
3 3
